%%%%%%%%%%%%%%%%%%%%%%
%R$                  %
%$    B              %
%                    %
%          %         %
%                    %
%                    %
%        %           %
%                    %
%                    %
%%%%%%%%%%%%%%%%%%%%%%
